BLUE	B L UW
BRIGHTNESS	B R AY T N AH S
CHANGE	CH EY N JH
COLOR	K AH L ER
GREEN	G R IY N
HEY	HH EY
HUE	HH Y UW
LAMP	L AE M P
LAMPI	L AE M P IY
OFF	AO F
ON	AA N
ONE	W AH N
ORANGE	AO R AH N JH
POINT	P OY N T
POWER	P AW ER
PURPLE	P ER P AH L
RED	R EH D
SATURATION	S AE CH ER EY SH AH N
SET	S EH T
THE	DH AH
TO	T UW
TOGGLE	T AA G AH L
TURN	T ER N
YELLOW	Y EH L OW
ZERO	Z IY R OW
